|   |   |   |   |   |   |   |   |   |   |   |   |   |   |   |   |   |   |   |   |
|   | * | # |   | # | # |   | # | # | # | # | # | # |   | # | # |   | # | # |   |
|   |   | # | # | # |   |   | # | # |   |   |   |   |   |   |   |   |   | # |   |
|   |   | # |   |   | # | # |   |   |   |   | # |   | # | # | # | # | # | # |   |
|   |   | # |   | O | # |   |   | # | # | # | # |   | # |   |   |   |   |   |   |
|   | # | # |   | # |   |   |   |   | # | # | # |   | # |   |   |   |   | # |   |
|   |   |   |   | # |   | # | # | # |   |   |   |   | # |   |   |   |   | # |   |
|   |   |   |   |   |   | # |   | # | # | # | # | # | # |   |   |   |   | # |   |
| # | # | # | # | # | # | # |   | # |   |   |   |   |   |   |   |   |   |   |   |
|   |   |   |   |   |   |   |   | # |   | # | # | # | # | # | # | # | # | # |   |
|   |   |   |   |   |   |   |   |   |   | # |   |   |   |   |   |   |   |   |   |
|   | # | # |   | # | # |   | # | # |   | # |   |   |   |   |   |   |   |   |   |
| # |   | # | # | # |   |   |   |   |   | # |   |   |   |   |   |   |   |   |   |
| # |   | # |   |   | # | # | # | # |   | # |   |   |   |   |   |   |   |   |   |
| # |   |   |   | O | # |   |   |   |   | # |   |   |   |   |   |   |   |   |   |
| # |   | # | # | # |   |   |   |   |   | # |   |   |   |   |   |   |   |   |   |
|   |   |   |   | # | # | # | # | # |   | # |   |   |   |   |   |   |   |   |   |
|   |   |   |   | # |   |   |   |   |   | # |   |   |   |   |   |   |   |   |   |
|   |   |   |   |   |   |   |   |   |   | # |   |   |   |   |   |   |   |   |   |
|   |   |   |   |   |   |   |   |   |   | # |   |   |   |   |   |   |   |   |   |
