| | | | | | | | | | |
| |*|#| |#|#| |#|#| |
|#| |#|#|#| | |#|#| |
|#| |#| | |#|#| | | |
|#| |#| |O|#| | | | |
|#|#|#| |#| | | | | |
| | | | |#|#|#|#|#| |
| | | | |#| | | | | |
| | | | | | | | | | |
| | | | | | | | | | |
