| # | * | # |   |   |
| # |   | # |   |   |
| # |   | # |   |   |
| # |   | # |   |   |
| # |   | # | # | # |
| # |   |   |   | O |
